11111111111111111111
1111111C0100C001C001
101111C0010E00000101
10C10001010000CCC001
1P111011010000000101
1010001C011110000001
10100010010000010101
10100000C000C0C01001
1000000000000111C101
1000000000000111C101
1000000000000111C101
1000000000000111C101
1000000000000111C101
1000000000000111C101
1000000000000111C101
1000000000000111C101
1000000000000111C101
1000000000000111C101
1000000000000111C101
1000000000000111C101
1000000000000111C101
1000000000000111C101
1000000000000111C101
1000000000000111C101
1000000000000111C101
1000000000000111C101
1000000000000111C101
1000000000000111C101
1000000000000111C101
1000000000000111C101
1000000000000111C101
1000000000000111C101
1000000000000111C101
1000000000000111C101
1000000000000111C101
1000000000000111C101
1000000000000111C101
1000000000000111C101
1000000000000111C101
1000000000000111C101
1000000000000111C101
1000000000000111C101
1000000000000111C101
1000000000000111C101
1000000000000111C101
1000000000000111C101
1000000000000111C101
1000000000000111C101
1000000000000111C101
1000000000000111C101
1000000000000111C101
1000000000000111C101
1000000000000111C101
1000000000000111C101
1000000000000111C101
1000000000000111C101
1000000000000111C101
1000000000000111C101
1000000000000111C101
1000000000000111C101
1000000000000111C101
1000000000000111C101
1000000000000111C101
1000000000000111C101
1000000000000111C101
1000000000000111C101
1000000000000111C101
1000000000000111C101
1000000000000111C101
1000000000000111C101
1000000000000111C101
1000000000000111C101
1000000000000111C101
1000000000000111C101
1000000000000111C101
1000000000000111C101
1000000000000111C101
1000000000000111C101
1000000000000111C101
1000000000000111C101
1000000000000111C101
1000000000000111C101
1000000000000111C101
1000000000000111C101
1000000000000111C101
1000000000000111C101
1000000000000111C101
1000000000000111C101
1000000000000111C101
1000000000000111C101
1000000000000111C101
1000000000000111C101
1000000000000111C101
1000000000000111C101
1000000000000111C101
1000000000000111C101
1000000000000111C101
1000000000000111C101
1000000000000111C101
1000000000000111C101
1000000000000111C101
1000000000000111C101
1000000000000111C101
1000000000000111C101
1000000000000111C101
1000000000000111C101
1000000000000111C101
1000000000000111C101
1000000000000111C101
1000000000000111C101
1000000000000111C101
1000000000000111C101
1000000000000111C101
1000000000000111C101
1000000000000111C101
1000000000000111C101
1000000000000111C101
1000000000000111C101
1000000000000111C101
1000000000000111C101
1000000000000111C101
1000000000000111C101
1000000000000111C101
1000000000000111C101
1000000000000111C101
1000000000000111C101
1000000000000111C101
1000000000000111C101
1000000000000111C101
1000000000000111C101
1000000000000111C101
1000000000000111C101
1000000000000111C101
1000000000000111C101
1000000000000111C101
1000000000000111C101
1000000000000111C101
1000000000000111C101
1000000000000111C101
1000000000000111C101
1000000000000111C101
1000000000000111C101
1000000000000111C101
1000000000000111C101
1000000000000111C101
1000000000000111C101
1000000000000111C101
1000000000000111C101
1000000000000111C101
1000000000000111C101
1000000000000111C101
1000000000000111C101
1000000000000111C101
1000000000000111C101
1000000000000111C101
1000000000000111C101
1000000000000111C101
1000000000000111C101
1000000000000111C101
1000000000000111C101
1000000000000111C101
1C100C111111C0C0C0C1
11111111111111111111