1111111111111
100000000C001
100C011111101
1E0C11100CP01
100C011111101
1111111111111