1111111111111
1C0100000C011
100C01C111C01
1E0C11C00CP01
101C011111C01
1111111111111