11111111111111111111
1111111C0100C001C001
101111C0010E00000101
10C10001010000CCC001
1P111011010000000101
1000001C000110000001
10100000010000010101
1000001C000110000001
10100000010000010101
1000001C000110000001
10100000010000010101
11111111111111111111