1111111111111
100100E000011
100C0111110P1
10001110C0001
1111111111111