1111111111111
1001000000011
1000011111001
1000111000001
1111111111111