1111111111111
100100000C011
100C011111C01
1E0C11100CP01
1111111111111